1111111111111111111111111111111111111111111111
1000000000000000000000000000000000000000000001
1000000000000000111100000000000000000000000001
1E000M000000000C00000C00M000000000000000000001
1010010100100000100001000000000000000000010101
1010010010101010000001000001111111000000010101
1010010010000010001001000000000000000000010101
1010010000001010001001000000011111000000010101
1010010010001010001001000000000000000000010101
1P0000000000C0000000000000M00000000000000000C1
1000000000000000001111000000000000000000000001
1000000000000000000000000000000000000000000001
1000000100000000000000000000000000010000000001
1000000100000000000011110000000000010000000001
100000010000000000100C00010000000001000000C001
1000000000000000001000000100000000000000000001
1111111111111111111111111111111111111111111111