1111111111111111111111111111111111
1E000M000000000C00000C00M000000001
1010010100100000101001000000010101
1010010100100000101001000000010101
101001010010000010C001000C00010101
10100C0010101010001001000000010101
100001010010000010C000000000010101
1010010100100000101001000000010101
1010010100100000101001000000010101
1P0000000C00C0000000000000M00000C1
1111111111111111111111111111111111