1111111111111111111111111111111111111111111111111111111111111111111
100E0M000000000C00000C00M0000000010000M000000000C00000C00M000000001
1010010100100000101001000000010101010010100100000101001000000010101
101001010010000010100100000001010101001010010000010C001000C00010101
10100C00101010100010010000000101010100C0010101010001001000000010101
10100C00101010100010010000000101010100C0010101010001001000000010101
10100C00101010100010010000000101010100C0010101010001001000000010101
10100C00101010100010010000000101010100C0010101010001001000000010101
10100C00101010100010010000000101010100C0010101010001001000000010101
10100C001010101000100100000001010100001010010000010C000000000010101
1010010100100000101001000000010101010010100100000101001000000010101
10P0000C00C0000000000000M00000C111111111111111111111111111111111111
1111111111111111111111111111111111111111111111111111111111111111111